O........S
..........
..........
....O.....
....OOOOOO
....O.....
..........
..........
..E.......
.........O